1,1,1,1,1,1,1,1,1,1,1,1,1,1,1
1,0,0,3,0,0,0,0,0,1,1,1,1,1,1
1,0,2,0,0,0,3,0,3,1,1,1,1,1,1
1,0,0,2,0,2,0,3,0,1,1,1,1,1,1
1,1,3,0,0,3,0,2,0,0,0,0,0,0,1
1,1,0,2,0,2,2,0,0,2,3,0,0,0,1
1,1,0,0,3,0,0,2,0,2,0,2,0,1,1
1,1,0,2,0,1,1,1,1,2,3,2,0,1,1
1,1,3,0,3,1,2,3,3,0,0,0,3,1,1
1,1,0,2,0,1,3,3,1,2,0,2,0,1,1
1,1,0,0,0,1,3,3,1,0,3,0,0,1,1
1,0,3,2,0,1,1,1,1,2,0,2,0,1,1
1,0,0,3,3,0,0,0,0,0,2,0,3,0,1
1,0,2,3,0,0,0,0,0,3,0,0,0,3,1
1,1,1,1,1,1,1,1,1,1,1,1,1,1,1
5
4,2
8,5
12,5
3,10
6,13
3
1,13,13
2,4,8
3,3,13
6,9
1,1,45,45