1,1,1,1,1,1,1,1,1,1,1,1,1,1,1
1,0,0,0,0,0,0,3,0,0,0,0,0,0,1
1,0,2,0,2,0,2,3,2,0,2,0,2,0,1
1,0,0,3,0,0,3,0,0,3,0,0,3,0,1
1,0,2,0,2,0,1,1,1,1,2,0,2,0,1
1,0,0,3,0,0,1,0,0,1,0,0,0,0,1
1,3,1,1,1,1,1,3,0,1,1,1,2,3,1
1,0,1,0,0,3,3,0,2,0,0,1,2,0,1
1,0,1,0,3,1,1,1,0,0,0,1,2,0,1
1,3,1,2,0,1,0,1,0,2,3,1,0,3,1
1,0,1,3,0,1,0,1,0,0,0,1,2,0,1
1,0,1,0,2,1,0,1,3,1,1,1,0,0,1
1,0,1,0,0,1,0,0,3,0,0,2,0,0,1
1,3,1,3,0,1,3,0,2,0,0,3,0,3,1
1,1,1,1,1,1,1,1,1,1,1,1,1,1,1
12
1,4
1,8
3,7
3,11
5,5
7,12
8,6
8,9
9,2
10,8
12,5
13,12
5
1,3,3
2,6,3
3,7,1
2,12,3
3,13,6
3,13
1,1,45,45
13,1,585,45