1,1,1,1,1,1,1,1,1,1,1,1,1,1,1
1,0,0,0,3,0,3,0,3,0,3,3,3,0,1
1,0,2,3,2,3,2,0,2,3,2,3,2,3,1
1,3,3,0,3,0,3,3,0,0,3,0,3,0,1
1,0,2,3,2,3,2,0,2,3,2,3,2,3,1
1,3,0,3,0,0,3,0,3,0,3,0,0,3,1
1,0,2,0,2,3,2,3,2,0,2,3,2,0,1
1,3,3,0,3,0,3,0,3,0,3,0,3,0,1
1,0,2,3,2,3,2,3,2,3,2,0,2,3,1
1,3,0,0,0,3,3,0,3,0,3,3,3,0,1
1,3,2,3,2,0,2,3,2,3,2,0,2,0,1
1,0,3,0,0,3,0,3,0,3,0,3,0,3,1
1,3,2,0,2,0,2,0,2,3,2,0,2,0,1
1,0,3,0,3,3,0,3,0,0,3,3,0,3,1
1,1,1,1,1,1,1,1,1,1,1,1,1,1,1
2
13,3
3,13
3
1,4,1
2,3,8
3,11,6
13,13
1,1,45,45