1,1,1,1,1,1,1,1,1,1,1,1,1,1,1
1,0,0,3,1,0,2,2,2,0,1,0,0,0,1
1,0,2,0,1,0,3,3,3,0,1,0,2,0,1
1,0,3,3,1,0,2,0,2,0,1,3,0,3,1
1,3,2,0,1,0,0,2,0,0,1,0,2,0,1
1,0,0,0,1,0,0,2,0,0,1,0,0,0,1
1,3,2,0,1,0,2,0,2,0,1,3,2,0,1
1,0,0,0,1,0,0,0,0,0,1,0,0,3,1
1,0,2,0,1,0,2,0,2,0,1,0,2,0,1
1,3,3,0,1,0,0,0,0,0,1,3,0,0,1
1,3,2,3,1,1,1,3,1,1,1,0,2,0,1
1,0,0,0,0,0,0,0,0,0,0,3,0,0,1
1,3,2,0,2,0,2,0,2,0,2,0,2,3,1
1,0,0,0,0,3,0,3,0,3,0,0,0,0,1
1,1,1,1,1,1,1,1,1,1,1,1,1,1,1
13
1,2
2,13
3,7
5,4
5,6
5,12
7,8
9,4
9,9
9,12
11,7
11,13
13,4
5
1,3,1
2,5,13
3,7,6
2,11,3
3,8,2
7,2
1,1,45,45
13,1,585,45