1,1,1,1,1,1,1,1,1,1,1,1,1,1,1
1,0,0,0,3,1,1,1,1,1,0,0,3,0,1
1,0,0,0,3,1,1,1,1,1,3,0,0,3,1
1,3,2,3,0,1,1,1,1,1,3,0,2,0,1
1,0,3,3,0,1,1,1,1,1,3,0,0,3,1
1,0,2,0,0,0,0,0,0,3,0,0,2,3,1
1,0,2,2,2,0,2,0,2,0,2,2,2,0,1
1,3,0,3,0,0,0,3,3,0,0,3,0,3,1
1,1,1,0,1,1,1,1,1,1,1,0,1,1,1
1,1,0,0,3,3,1,1,1,3,3,0,0,1,1
1,1,2,3,2,3,1,1,1,0,2,0,2,1,1
1,1,3,0,3,0,0,0,0,0,0,3,0,1,1
1,1,2,0,2,0,1,1,1,0,2,3,2,1,1
1,1,0,3,0,0,1,1,1,3,3,3,3,1,1
1,1,1,1,1,1,1,1,1,1,1,1,1,1,1
7
1,6
3,12
5,5
9,11
10,7
11,3
12,11
3
1,4,1
2,10,3
3,7,7
12,13
1,1,45,45
13,1,585,45