1,1,1,1,1,1,1,1,1,1,1,1,1,1,1
1,0,0,0,1,1,1,1,1,1,1,0,0,0,1
1,0,2,0,1,3,3,3,3,3,1,0,2,0,1
1,0,0,0,1,0,2,0,2,0,1,0,0,0,1
1,1,1,3,1,0,3,0,3,0,1,3,1,1,1
1,1,0,3,0,0,2,2,2,3,0,0,3,1,1
1,1,2,2,0,0,0,0,3,3,3,2,2,1,1
1,1,2,2,0,1,1,0,1,1,0,2,2,1,1
1,1,3,0,3,1,0,3,0,1,0,0,0,1,1
1,1,1,1,1,1,3,0,0,1,1,1,1,1,1
1,1,1,1,0,0,2,3,2,0,0,1,1,1,1
1,1,1,1,0,0,3,3,3,0,0,1,1,1,1
1,1,1,1,0,3,2,0,2,0,3,1,1,1,1
1,1,1,1,3,3,0,0,0,3,3,1,1,1,1
1,1,1,1,1,1,1,1,1,1,1,1,1,1,1
8
4,6
4,10
7,4
7,13
8,9
9,4
10,10
11,8
5
1,3,4
2,4,13
3,7,2
2,10,3
3,9,6
10,13
1,1,45,45
13,1,585,45