1,1,1,1,1,1,1,1,1,1,1,1,1,1,1
1,1,1,1,0,0,1,3,1,0,0,1,1,1,1
1,1,1,1,0,3,1,3,1,0,3,1,1,1,1
1,1,1,1,3,0,3,0,0,3,0,1,1,1,1
1,0,0,3,3,0,0,0,0,3,3,0,0,0,1
1,0,3,2,0,2,0,2,3,2,0,2,0,0,1
1,0,3,3,0,3,3,0,3,0,0,0,3,0,1
1,3,3,2,0,2,0,2,0,2,0,2,0,0,1
1,0,0,0,3,0,3,0,3,0,0,3,0,3,1
1,0,3,0,0,2,0,2,0,2,0,3,0,3,1
1,0,0,3,0,0,0,3,0,0,3,0,0,0,1
1,1,1,1,3,0,2,0,2,3,0,1,1,1,1
1,1,1,1,0,3,3,2,0,0,3,1,1,1,1
1,1,1,1,0,0,3,0,0,3,0,1,1,1,1
1,1,1,1,1,1,1,1,1,1,1,1,1,1,1
8
5,1
9,1
5,4
13,6
10,8
4,9
6,10
8,12
3
1,6,6
2,10,10
3,3,10
7,1
7,13,315,585