1,1,1,1,1,1,1,1,1,1,1,1,1,1,1
1,0,0,0,0,0,1,1,1,0,3,3,0,3,1
1,0,2,3,2,3,1,1,1,0,2,0,2,0,1
1,3,3,0,3,3,1,1,1,3,0,3,3,0,1
1,3,2,0,2,0,1,1,1,3,2,0,2,3,1
1,3,0,0,0,0,1,1,1,3,3,3,0,0,1
1,0,2,3,2,3,1,1,1,0,2,0,2,3,1
1,3,3,3,0,0,0,0,0,0,3,0,3,0,1
1,0,2,3,2,0,1,1,1,0,2,0,2,3,1
1,3,0,0,0,3,1,1,1,3,0,3,0,0,1
1,0,2,3,2,3,1,1,1,0,2,0,2,3,1
1,0,0,3,3,0,1,1,1,3,0,3,0,0,1
1,3,2,0,2,0,1,1,1,0,2,0,2,0,1
1,0,0,3,3,0,1,1,1,0,3,3,0,0,1
1,1,1,1,1,1,1,1,1,1,1,1,1,1,1
4
3,5
7,7
2,11
13,9
3
1,11,13
2,5,10
3,9,3
13,1
1,1,45,45