1,1,1,1,1,1,1,1,1,1,1,1,1,1,1
1,0,3,0,3,0,3,0,3,0,3,3,3,0,1
1,0,2,3,2,3,2,0,2,3,2,3,2,3,1
1,3,3,0,3,0,3,3,0,0,3,0,3,0,1
1,0,2,3,2,3,2,0,2,3,2,3,2,3,1
1,3,0,3,0,0,3,0,3,0,3,0,0,3,1
1,0,2,0,2,3,2,3,2,0,2,3,2,0,1
1,3,3,0,3,0,3,0,3,0,3,0,3,0,1
1,0,2,3,2,3,2,3,2,3,2,0,2,3,1
1,3,0,0,0,3,3,0,3,0,3,3,3,0,1
1,3,2,3,2,0,2,3,2,3,2,0,2,0,1
1,0,3,0,0,3,0,3,0,3,0,3,0,3,1
1,3,2,0,2,0,2,0,2,3,2,0,2,0,1
1,0,3,0,3,3,0,3,0,0,3,3,0,3,1
1,1,1,1,1,1,1,1,1,1,1,1,1,1,1
2
13,3
2,13
3
5,13
3,8
12,6